2 13 31
###############################
#p *bb *1  11  *  ** * * 1   *#
# * # # #*# # #*# # # # # #*# #
#    * * *** **      *    **  #
# #*# # # # #1# #b#1# # # # #*#
#  1111    *     **  1   *  **#
# # #*# # # # # #*#*#*#*# # # #
#   *  1      *   * *x* *     #
# # # # #*# # # # # # #*# #*# #
#   ****         *1    1      #
# # # # # # # # # #*# # # # #*#
#  ** *   *    2   1   s      #
###############################